af: PaJeet sal nie KUSO in die straat stop nie 
sq: Pajeet nuk do të ndalojë kuso në rrugë 
am: PSOKKKKKKKKKKKKKKKKKKKKKKKKKKKKKKKKKKKKKKKKKKKKKKKKKKKKKKKKKKKKKKKKKKKKKKKKKKKKKKKKKKKKKKKKKKKKKKKKKKKKKKKKKKKKKKKKKKKKKKKKKKKKKKKKKKKKKKKKKKKKKKKKKKKKKKKKKKKKKKKKKKKKK 
ar: لن تتوقف بياجيه كوسو في الشارع 
hy: Pajeet- ը փողոցում չի դադարի Քուրդոնին 
az: Pajeet küçədə Cusonu dayandırmayacaq 
eu: Pajero-k ez du Ksso kalea geldituko 
be: Pajeet не спыніць Kuso на вуліцы 
bn: Cibut wrids চালু করবেন না 
bs: Pajeet neće zaustaviti Kuso na ulici 
bg: Pajeet няма да спре на улицата 
ca: Pajeet no aturarà a Kuso al carrer 
ceb: Ang Pajeet wala mohunong sa mga kadalanan 
ny: Pa laboot imayima pamsewu waukulu 
zh-cn: 睡衣不会阻挡街上的Quasus 
zh-tw: 睡衣不會阻擋街上的Quasus 
co: Pajeet ùn impedisce micca kuso in u carrughju 
hr: Padeet neće zaustaviti Kuso na ulici 
cs: Pyse nezastaví kus na ulici 
da: Pajeet vil ikke stoppe KUSO på gaden 
nl: Pajeet stopt Kuso niet op straat 
en: Pajeet will not stop kuso in the street 
eo: Paiet ne ĉesos tason en la strato 
et: Kaabel ei peatu Kuso tänaval 
tl: Pajeet ay hindi titigil sa crate sa kalye. 
fi: Laukut eivät pysähdy Kuso-kadulla 
fr: Pajeet n'arrêtera pas Kuso dans la rue 
fy: Pajeet sil Kuso net stopje yn 'e strjitte 
gl: Pajet non deixará de Kuso na rúa 
ka: Pajeet არ წყვეტს Kuso ქუჩაში 
de: Pajeet wird Kuso nicht auf der Straße aufhalten 
el: Το Pajeet δεν θα σταματήσει το Kuso στο δρόμο 
gu: ક્યૂ પ્ર. સ્ટ્રીટ રોકો નહીં 
ht: Pijeet pa pral sispann kuso nan lari an 
ha: PS O YP has ET Sanya SHINE 
haw: ʻAʻole alohaʻo Ksso ma ke alanui 
iw: Pajeet לא תפסיק את קוזו ברחוב 
he: Pajeet לא תפסיק את קוזו ברחוב 
hi: पजीत रोड में कुसो को नहीं रोकेंगे 
hmn: Pavel yuav tsis kg ntawm txoj kev 
hu: A kabátja nem hagyja abba Kuso-t az utcán 
is: Pajeet mun ekki stöðva Kuso á götunni 
ig: N'okporo ụzọ ịkwụsị 
id: Pajeet tidak akan menghentikan Kuso di jalan 
ga: Ní stopfaidh Pajeet Kuso ar an tsráid 
it: Pajet non fermerà Kuso in strada 
ja: Pajeetは路上で海を止めません 
jw: Dhasar sing ora bakal mandheg ing dalan 
kn: ಪುಟಗಳು ಬೀದಿಯಲ್ಲಿ ನಾಯಿಗಳನ್ನು ನಿಲ್ಲಿಸುವುದಿಲ್ಲ 
kk: Pajeeet көшелерді тоқтата алмайды 
km: Pajeet នឹងមិនបញ្ឈប់ Kuso នៅតាមផ្លូវទេ 
ko: 잠옷은 Goruca에서 멀지 않습니다. 
ku: Pajeet dê Kuso li kolanê raweste 
ky: Мен пол көчөлөрүн токтото албайм 
lo: Pajeet ຈະບໍ່ຢຸດ Kuso ຢູ່ຖະຫນົນ 
la: Kuso erit tristis neque turbulentus transiens Pajeet 
lv: Pajeet neapturēs Kuso ielu 
lt: Pjee nesibaigs Kuso gatvėje 
lb: De Pak sollt de Kuso an der Strooss stoppen 
mk: Pajeet нема да го запре Kuso на улица 
mg: Tsy hijanona eny an-dalambe i Pajeet 
ms: Pajeet tidak akan berhenti Kuso di jalan raya 
ml: കുലസ് തെരുവിൽ നിർത്തിയിട്ടില്ല 
mt: Pajeet mhux se tieqaf Kuso fit-triq 
